##################################################
#OO..O.....O.OOO..O.....O....O.......O..O.....O.##
#.OO....O...O...#.O...O.......#.#O..O.OO.......###
#O.O.........OO.OOO.O...#...#O.#.OO.#..O.#O.O....#
#.O....OO..O.................#O.O.OO......O#OOO.O#
#O..#.O...O...O....OO..O.........O..O..O#O#..O..O#
#.#.OO.#....#..O#.....#..O....OO........#....O...#
#...O.O.O.......O.OOO...O.....OO...OO.....O..#..##
#O.#O..OO...OOO.O.#O...OOO.OO...O...O..O.........#
#...O........OO..O...###.OO.#O.OO.OO.............#
#..OOO...O..O.....O.#O.....OO.O..O...O...........#
#O..O#O.O.O.OO...#....O#.............#...#.OO.OO.#
#.#.OOOO...O..O.O..O...........#.....OOO.....O...#
#............O...O....O.....O#.OO...#.#..O...O#..#
#...O..O..#....#.OO..OO.#...O...OO..OO..O.##.#OO.#
#.O............#.........OO.#...OO....O........#.#
#...#..#.OO.O....O#........#OO.O#..O..OO..O.....O#
#.O.....O.....O..#..#OO.O...O........OO.OO.O.O.OO#
#.#O..O....O..O#.OOO.OOOOO..#.....OO....O...O.O..#
#...O..........#.......OO.O..O.#......#..O..OO...#
#O#.O.#...O......O#.OOO..O#.OOO.O.....O..OO......#
#.#O.O.#.....#.O......OO...O.O.O.OO.......O.O..OO#
#....O#....#OO....O.O#.OO.O....O.....O.O..OO.....#
#..O.O...#O..#O...OO.OO....O.....#....O..OO..O..O#
#.#OO.....O.OO..O.OO.O..@....#.OOOO.OO..O......OO#
#O..O...O...OO.O..O.....OOOO.....#O..#OOO.O..O..##
#..O.#OO#..O..#.......O..O.........O........OO#..#
#O..#O......#....OO...O.OOOO..#OOO..O...O....OOO.#
#..O.OO.......OO.......O...#.O..OO....OOO#..#.O..#
#...O...OOOO...#..O..O..O....O...#O....O..O.....O#
#.O....#..OOOO...OO..O.......O.O.O.....O.........#
#..OO.O.....OO..#.O...#O..O...O#.......O.O.OOO...#
#OO.OOO..O.......O....OO...OO#...#...OO....O..O.O#
#O.O..#O..#...O.O..O.O..O......OO#..O.......O...##
#.O#O.#..OOOO..OO......O...O..O.....O...O.O..O.#O#
#.....#OO.O.O....O.O.....O.O....O......OO..##.##O#
#O............O...OO.O.O....O..O..O#OO..O#..#..O.#
#..##OO.....O..#.O......O..#.O##..O..#OO....OO.O.#
#...O.#...O.....O#.O#O.O..OO##.....O#.....O.O..O.#
#O##..O.......OO....O...O....#O....O..O.O..O..O..#
#....#...O....O..O...........OO......#O..#.#O....#
#..OOO#.........#..........O....O.............O..#
#........OO.O...OO..O#OO..O#O......OOOO.O.#O..O..#
#.O.O.....O.O....#.O..OO....O#...O....OOO........#
#..O#.O....O..O..O#...O...O.....O...O.O.O..O.....#
##..O#.OO#.#..#..O...#...OO.....O.O#O.....OO..#..#
#...O.O.......#.OOOO.OO#..OO...OO.O.........OO...#
#..#.##O....O.........O.......OO......#O...O.OOO.#
#OO..O...OO....O.OO..O....#.#O...#O.O..OOOO.O.#O.#
##################################################